
NO Bonus/textures/Wall2.png
SO Bonus/textures/Wall2.png
WE Bonus/textures/Wall2.png
EA Bonus/textures/Wall2.png


F 32,0,1

C 0,25,51




1111111111111111111111111111111111111111111111111111111111111111111111111111111111111111
1111111111111111111111111111111111111111111111111111111111111111111111111111111111111111111
1000000000000000000000000000000000000000000000000000000000000000000000000000000000000000001
11111111111111111111111D111111111111111111111111111111111D111111111111111111111111111111101
                      101                               101                             101
                      101                               101                             101
          1111111111111D11111111111111111111            101                             101
          100000000000D0D0D0D000000000000001            101                             11
          1011111111111D11111111111111111101            1D1                             101
          101         101                101            101                             101
          101         101                101            101                             101
1111111111D11111111111D111111111111111111D111111111111110111                            111
1111111111111111111111111111111111111111111111111111111111111111111111111111111111111111111
1000000000100000000000000100000000000000000000000000000000001                           101
1000000000100000000000000100000000000000000000000000000000011111111111111111111111111111D11
1000000000100000000000000100000000010100000000000000000000000DD10000000000000000000000000011111
1000000000100000000000001000000000101000000000000000000000011111111111111111111111111111D1111111
100000000010000000000000010000000111D111100000000000000000001                           101
1000000000100000000000000D00011111000000111110000000000000001                           101
10000000001000001D110000010000000D000000D00000000000000000001                           101
100000000111111100D000000000111111111111111000000000000000011                           101
1000000000000000001100000000000001DD1DDD100000000000000000001                           101
1000000000000000000000000001000001111111100000000000000000001                           101
1000000000000000000000000001000000001110000000000000000000001                           101
1000000000000000000000000001000000101010000000000000000000001                           101
1000000000000000000000000001000000000000000000000000000000001                           101
1000000000001D10000000001001000000000000000000000000000000001                           101
1000000100000000000000000001000000000000000000000000000000001                           101
100000E000000000000000000001000000000000000000000000000000001                           101
1000000000000000000000000001000000000000000000000000000000001                           101
10000000000000000000000000010000000000000000000000000000000011111111111111111111111111111D1
1111111111111111111111111111111111111111111111111111111111111111111111111111111111111111111
